XXXXXXX2222XXXXXXX
X              H0X
X                X
X                X
X                X
X                X
XTTTTXX   XH1    X
X     X XX       X
X    SXX         X
X     X XX H2    X
X    XX   X      X
X                X
X                X
X     B2         X
X             TTTX
X             TH0X
X     TTTTTT  T  X
XXXXXXX1111XXXXXXX
